07 07 02
XXXXXXX
XMXG..X
X.J...X
XX..XJX
XX....X
XXX..GX
XXXXXXX