07 12 05
XXXXXXX
X..MXXX
X.JJ.XX
X.J.JXX
X..J..X
X...X.X
X...X.X
XX..G.X
XXX.GGX
X..GG.X
X.....X
XXXXXXX
