10 06 02
XXXXXXXXXX
XXXXXX..XX
X..J.G..XX
X.XXX...XX
XGM..J..XX
XXXXXXXXXX
