09 09 03
XXXXXXXXX
XX...XXXX
XX...X..X
XXX....GX
XXX.XXXGX
X.J.XXXGX
X.JJXXXXX
XM..XXXXX
XXXXXXXXX
